ankara : akyurt,altindag,ayas,bala,beypazari,camlidere,cankaya,cubuk,elmadag,etimesgut,evren,golbasi,gudul,haymana,kahramankazan,kalecik,kecioren,kizilcahamam,mamak,nallihan,polatli,pursaklar,sereflikochisar,sincan,yenimahalle
istanbul : adalar,arnavutkoy,atasehir,avcilar,bagcilar,bahcelievler,bakirkoy,basaksehir,bayrampasa,besiktas,beykoz,beylikduzu,beyoglu,buyukcekmece,catalca,cekmekoy,esenler,esenyurt,eyupsultan,fatih,gaziosmanpasa,gungoren,kadikoy,kagithane,kartal,kucukcekmece,maltepe,pendik,sancaktepe,sariyer,sile,silivri,sisli,sultanbeyli,sultangazi,tuzla,umraniye,uskudar,zeytinburnu
izmir : aliaga,balcova,bayindir,bayrakli,bergama,beydag,bornova,buca,cesme,cigli,dikili,foca,gaziemir,guzelbahce,karabaglar,karaburun,karsiyaka,kemalpasa,kinik,kiraz,konak,menderes,menemen,narlidere,odemis,seferihisar,selcuk,tire,torbali,urla
adana : aladag,ceyhan,cukurova,feke,imamoglu,karaisali,karatas,kozan,pozanti,saimbeyli,saricam,seyhan,tufanbeyli,yumurtalik,yuregir
adiyaman : besni,celikhan,gerger,golbasi,kahta,merkez,samsat,sincik,tut
afyonkarahisar : basmakci,bayat,bolvadin,cay,cobanlar,dazkiri,dinar,emirdag,evciler,hocalar,ihsaniye,iscehisar,kiziloren,merkez,sandikli,sinanpasa,suhut,sultandagi
agri : diyadin,dogubayazit,eleskirt,hamur,merkez,patnos,taslicay,tutak
aksaray : agacoren,eskil,gulagac,guzelyurt,merkez,ortakoy,sariyahsi,sultanhani
amasya : goynucek,gumushacikoy,hamamozu,merkez,merzifon,suluova,tasova
antalya : akseki,aksu,alanya,demre,dosemealti,elmali,finike,gazipasa,gundogmus,ibradi,kas,kemer,kepez,konyaalti,korkuteli,kumluca,manavgat,muratpasa,serik
ardahan : cildir,damal,gole,hanak,merkez,posof
artvin : ardanuc,arhavi,borcka,hopa,kemalpasa,merkez,murgul,savsat,yusufeli
aydin : bozdogan,buharkent,cine,didim,efeler,germencik,incirliova,karacasu,karpuzlu,kocarli,kosk,kusadasi,kuyucak,nazilli,soke,sultanhisar,yenipazar
balikesir : altieylul,ayvalik,balya,bandirma,bigadic,burhaniye,dursunbey,edremit,erdek,gomec,gonen,havran,ivrindi,karesi,kepsut,manyas,marmara,savastepe,sindirgi,susurluk
bartin : amasra,kurucasile,merkez,ulus
batman : besiri,gercus,hasankeyf,kozluk,merkez,sason
bayburt : aydintepe,demirozu,merkez
bilecik : bozuyuk,golpazari,inhisar,merkez,osmaneli,pazaryeri,sogut,yenipazar
bingol : adakli,genc,karliova,kigi,merkez,solhan,yayladere,yedisu
bitlis : adilcevaz,ahlat,guroymak,hizan,merkez,mutki,tatvan
bolu : dortdivan,gerede,goynuk,kibriscik,mengen,merkez,mudurnu,seben,yenicaga
burdur : aglasun,altinyayla,bucak,cavdir,celtikci,golhisar,karamanli,kemer,merkez,tefenni,yesilova
bursa : buyukorhan,gemlik,gursu,harmancik,inegol,iznik,karacabey,keles,kestel,mudanya,mustafakemalpasa,nilufer,orhaneli,orhangazi,osmangazi,yenisehir,yildirim
canakkale : ayvacik,bayramic,biga,bozcaada,can,eceabat,ezine,gelibolu,gokceada,lapseki,merkez,yenice
cankiri : atkaracalar,bayramoren,cerkes,eldivan,ilgaz,kizilirmak,korgun,kursunlu,merkez,orta,sabanozu,yaprakli
corum : alaca,bayat,bogazkale,dodurga,iskilip,kargi,lacin,mecitozu,merkez,oguzlar,ortakoy,osmancik,sungurlu,ugurludag
denizli : acipayam,babadag,baklan,bekilli,beyagac,bozkurt,buldan,cal,cameli,cardak,civril,guney,honaz,kale,merkezefendi,pamukkale,saraykoy,serinhisar,tavas
diyarbakir : baglar,bismil,cermik,cinar,cungus,dicle,egil,ergani,hani,hazro,kayapinar,kocakoy,kulp,lice,silvan,sur,yenisehir
duzce : akcakoca,cilimli,cumayeri,golyaka,gumusova,kaynasli,merkez,yigilca
edirne : enez,havsa,ipsala,kesan,lalapasa,meric,merkez,suloglu,uzunkopru
elazig : agin,alacakaya,aricak,baskil,karakocan,keban,kovancilar,maden,merkez,palu,sivrice
erzincan : cayirli,ilic,kemah,kemaliye,merkez,otlukbeli,refahiye,tercan,uzumlu
erzurum : askale,aziziye,cat,hinis,horasan,ispir,karacoban,karayazi,koprukoy,narman,oltu,olur,palandoken,pasinler,pazaryolu,senkaya,tekman,tortum,uzundere,yakutiye
eskisehir : alpu,beylikova,cifteler,gunyuzu,han,inonu,mahmudiye,mihalgazi,mihaliccik,odunpazari,saricakaya,seyitgazi,sivrihisar,tepebasi
gaziantep : araban,islahiye,karkamis,nizip,nurdagi,oguzeli,sahinbey,sehitkamil,yavuzeli
giresun : alucra,bulancak,camoluk,canakci,dereli,dogankent,espiye,eynesil,gorele,guce,kesap,merkez,piraziz,sebinkarahisar,tirebolu,yaglidere
gumushane : kelkit,kose,kurtun,merkez,siran,torul
hakkari : cukurca,derecik,merkez,semdinli,yuksekova
hatay : altinozu,antakya,arsuz,belen,defne,dortyol,erzin,hassa,iskenderun,kirikhan,kumlu,payas,reyhanli,samandag,yayladagi
igdir : aralik,karakoyunlu,merkez,tuzluca
isparta : aksu,atabey,egirdir,gelendost,gonen,keciborlu,merkez,sarkikaraagac,senirkent,sutculer,uluborlu,yalvac,yenisarbademli
kahramanmaras : afsin,andirin,caglayancerit,dulkadiroglu,ekinozu,elbistan,goksun,nurhak,onikisubat,pazarcik,turkoglu
karabuk : eflani,eskipazar,merkez,ovacik,safranbolu,yenice
karaman : ayranci,basyayla,ermenek,kazimkarabekir,merkez,sariveliler
kars : akyaka,arpacay,digor,kagizman,merkez,sarikamis,selim,susuz
kastamonu : abana,agli,arac,azdavay,bozkurt,catalzeytin,cide,daday,devrekani,doganyurt,hanonu,ihsangazi,inebolu,kure,merkez,pinarbasi,senpazar,seydiler,taskopru,tosya
kayseri : akkisla,bunyan,develi,felahiye,hacilar,incesu,kocasinan,melikgazi,ozvatan,pinarbasi,sarioglan,sariz,talas,tomarza,yahyali,yesilhisar
kirikkale : elbeyli,merkez,musabeyli,polateli
kirklareli : bahsili,baliseyh,celebi,delice,karakecili,keskin,merkez,sulakyurt,yahsihan
kirsehir : babaeski,demirkoy,kofcaz,luleburgaz,merkez,pehlivankoy,pinarhisar,vize
kilis : akcakent,akpinar,boztepe,cicekdagi,kaman,merkez,mucur
kocaeli : basiskele,cayirova,darica,derince,dilovasi,gebze,golcuk,izmit,kandira,karamursel,kartepe,korfez
konya : ahirli,akoren,aksehir,altinekin,beysehir,bozkir,celtik,cihanbeyli,cumra,derbent,derebucak,doganhisar,emirgazi,eregli,guneysinir,hadim,halkapinar,huyuk,ilgin,kadinhani,karapinar,karatay,kulu,meram,sarayonu,selcuklu,seydisehir,taskent,tuzlukcu,yalihuyuk,yunak
kutahya : altintas,aslanapa,cavdarhisar,domanic,dumlupinar,emet,gediz,hisarcik,merkez,pazarlar,saphane,simav,tavsanli
malatya : akcadag,arapgir,arguvan,battalgazi,darende,dogansehir,doganyol,hekimhan,kale,kuluncak,puturge,yazihan,yesilyurt
manisa : ahmetli,akhisar,alasehir,demirci,golmarmara,gordes,kirkagac,koprubasi,kula,salihli,sarigol,saruhanli,sehzadeler,selendi,soma,turgutlu,yunusemre
mardin : artuklu,dargecit,derik,kiziltepe,mazidagi,midyat,nusaybin,omerli,savur,yesilli
mersin : akdeniz,anamur,aydincik,bozyazi,camliyayla,erdemli,gulnar,mezitli,mut,silifke,tarsus,toroslar,yenisehir
mugla : bodrum,dalaman,datca,fethiye,kavaklidere,koycegiz,marmaris,mentese,milas,ortaca,seydikemer,ula,yatagan
mus : bulanik,haskoy,korkut,malazgirt,merkez,varto
nevsehir : acigol,avanos,derinkuyu,gulsehir,hacibektas,kozakli,merkez,urgup
nigde : altunhisar,bor,camardi,ciftlik,merkez,ulukisla
ordu : akkus,altinordu,aybasti,camas,catalpinar,caybasi,fatsa,golkoy,gulyali,gurgentepe,ikizce,kabaduz,kabatas,korgan,kumru,mesudiye,persembe,ulubey,unye
osmaniye : bahce,duzici,hasanbeyli,kadirli,merkez,sumbas,toprakkale
rize : ardesen,camlihemsin,cayeli,derepazari,findikli,guneysu,hemsin,ikizdere,iyidere,kalkandere,merkez,pazar
sakarya : adapazari,akyazi,arifiye,erenler,ferizli,geyve,hendek,karapurcek,karasu,kaynarca,kocaali,pamukova,sapanca,serdivan,sogutlu,tarakli
samsun : 19mayis,alacam,asarcik,atakum,ayvacik,bafra,canik,carsamba,havza,ilkadim,kavak,ladik,salipazari,tekkekoy,terme,vezirkopru,yakakent,atakum,canik,ilkadÄ±m
siirt : akcakale,birecik,bozova,ceylanpinar,eyyubiye,halfeti,haliliye,harran,hilvan,karakopru,siverek,suruc,viransehir
sinop : baykan,eruh,kurtalan,merkez,pervari,sirvan,tillo
sivas : ayancik,boyabat,dikmen,duragan,erfelek,gerze,merkez,sarayduzu,turkeli
sanliurfa : beytussebap,cizre,guclukonak,idil,merkez,silopi,uludere
sirnak : akincilar,altinyayla,divrigi,dogansar,gemerek,golova,gurun,hafik,imranli,kangal,koyulhisar,merkez,sarkisla,susehri,ulas,yildizeli,zara
tekirdag : cerkezkoy,corlu,ergene,hayrabolu,kapakli,malkara,marmaraereglisi,muratli,saray,sarkoy,suleymanpasa
tokat : almus,artova,basciftlik,erbaa,merkez,niksar,pazar,resadiye,sulusaray,turhal,yesilyurt,zile
trabzon : akcaabat,arakli,arsin,besikduzu,carsibasi,caykara,dernekpazari,duzkoy,hayrat,koprubasi,macka,of,ortahisar,salpazari,surmene,tonya,vakfikebir,yomra
tunceli : cemisgezek,hozat,mazgirt,merkez,nazimiye,ovacik,pertek,pulumur
usak : banaz,esme,karahalli,merkez,sivasli,ulubey
van : bahcesaray,baskale,caldiran,catak,edremit,ercis,gevas,gurpinar,ipekyolu,muradiye,ozalp,saray,tusba
yalova : altinova,armutlu,ciftlikkoy,cinarcik,merkez,termal
yozgat : akdagmadeni,aydincik,bogazliyan,candir,cayiralan,cekerek,kadisehri,merkez,saraykent,sarikaya,sefaatli,sorgun,yenifakili,yerkoy
zonguldak : alapli,caycuma,devrek,eregli,gokcebey,kilimli,kozlu,merkez
